11111111111111111111111111111111111111111111111111
10010000010000000000000100000000000000001000000001
10010000010000000000000100000000000000001000000001
10011100010000000000000100000000000000001000111001
10011100010000000000000100000000000000001000000001
10011100000000000000011111000000000000000000000001
10000000000001110000000100000000111000000000000001
11001111100000000000000000000000000000000111110011
11001111100000000000000000000000000000000111110011
10000000000000000000000000000000000000000000000001
10000000000000000001111111110000000000000000000001
10000001111100000000000100000000000000111110000001
10000001000000000000000100000000000000000010000001
10000001000000111000000100000011100000000010000001
10000001000000000000000100000000000000000010000001
10000000000000000000000000000000000000000000000001
11111100000000111111011111011111100000000000111111
10000011111000001000000000000010000000111110000001
10000010001000001000000000000010000000100010000001
10010000000000001000000000000010000000000000001001
10010000000000000000001100000000000000000000001001
10010001110000000000001100000000000000001110001001
10000001110000000000111111000000000000001110000001
10000000000000000000001100000000000000000000000001
11111111111111111111111111111111111111111111111111