11111111111111111111111111111111111111111111111111
10000000000000000011000000100000000000000000000001
10001111000011100011000000111110000000111110000001
10001111000011100011000000111110000000111110000001
10000000000000000011000000000000000000000000000001
10000000000000000011000000000000000000000000000001
10001111000011100011000000111110000000000000000001
10000000000000000000000000000000000000000000000001
10000000000000000000000000000001000000000000000001
10000000000011100011000000000001000000010000000001
10000000000000000011000000000001000000010000000001
10000011000000011111111000011111000000010000000001
10000011000000000011000000000001000000010000000001
11100011000000000011000000000001000000011110001111
10000011111000000000000000000000000000010000000001
10000011000000000000000000000000000000010000000001
10000011000000011111110000000000000000000000000001
10000000000000000010000000000011111000000000111111
10000000000000000010000000000000000000000000000001
10011100001110000010000000000000000010000001000001
10000100000000000000000011111110000000000001000001
10000100000000100000000000010000000000000001000001
10000000000111111110000000010000000001111111111001
10000000000000000000000000010000000000000000000001
11111111111111111111111111111111111111111111111111