11111111111111111111111111111111111111111111111111
10000000000000000000000100000000000000000000000001
10000111000001111000000100001110000011110000000001
10000111000001111000000100001110000011110000000001
10000000000000000000000100000000000000000000000001
10000000000000000000000000000000000000000000000001
10000000000010000000111111100000001000000000000001
10001110000010000000000100000000001000000111000001
10001110000011100000000100000000111000000111000001
10001110000010000000000000000000001000000111000001
10001110000010000100000100000100001000000111000001
10000000000000000100000100000100000000000000000001
10011111110000000100000000000100000001111111000001
10010000000010000111111111111100001000000001000001
10010000000010000000000000000000001000000001000001
10000000000010000000000000000000001000000000000001
10000000000010000000111111100000001000000000000001
10000011000000000000000100000000000000011000000001
10000001000000011110000100001111000000010000000001
10000001000000000000000000000000000000010000000001
10000000000000000000111111100000000000000000000001
11100000000000010000000100000001000000000000000111
10000000011111111100000100000111111111000000000001
10000000000000000000000000000000000000000000000001
11111111111111111111111111111111111111111111111111